50.ox
.......o.o.....o.o.o.......oo...o....o.....o....o....oo..oo.o..o.....o....oo.oo.o.o....oo.....oooooo
....o.o.......o.o..o.o.o...o.......o.....oo.o........o.....o.....oo.....o..o.o.....o...........oo...
o.o...o.........o........o.....oo..o......o..oo...o.......ooo...o.......o.....o.oo.....o.....o..o.oo
oo....o.o.o.o..o.ooo.o.........o......o.o.oo......o.o.o..o...oo....oooo......o..o...o.....o..o..o..o
...oo........o........oo.o.......o.ooo...oo....o.o.oo.....o.....o.o.oo.oo.......oo.o...o.o.o.......o
o.........o.o.......oo.o.o.o.oo.o.....o...o..oo.ooo.........o..o..o.o...ooo...o.o..oo.oo....ooo.....
oo...o.o.ooo..o.o.o.o......o.o..o.oo....o.o.o......o...ooo...o.....oo...oo.......o..........o....o..
ooo.o...o.........o.........o..ooo.......o.o.o.o.o.oo...oooo..o.o.o.o...oo..oo..o..o...o...o........
o...oo..o.....o....o...........oo.o.....o......oo...................o......ooo.o.o.oo.o.oo.....o.o.o
.o....o...o..oo..o......o..o...oooo..o....oo.o..o.......o...o......o.oo....o.o.....o...o..o.o.oo.o..
....o.....o.....o.o........oo..o.o.ooo...o......oo...ooo...oo..o.o...oo..o.oo.o.o..oo.o.o..oo.ooo...
.......o.......o..o.o...o.....o..o.......o.o...o.....o......oo...o.o.o....o.o....o..o.o..o.o...o...o
..ooo.oo.o..o...o........o...o....o..oo.o.oo.o..o.......o.oo.o...oo...o.o.....o...oo..o.oo.o..oo.o..
ooo..o...o.o..o..o.oo.oo...oo.oo........o..oo...o..o....o..o........oo.o..o.....ooo...o.o....ooo....
..o...o...o..o..o.oo.o....o.......o.o......o.oo.o...o.o.......o.o..o.......o......o....o...o.ooo.oo.
o.........o.o.....o.o..o.o....o.......oo...oo...o..oo.oo.....o.ooooo.o..o.........ooo....oo...oo..o.
..o.o......o.o.ooooo.oo.....oo.o.o.........oo.o..oo.o.oo.ooo...o........o...o......ooo.o...o.o..o.o.
o....o..oooo..oo.......oo.oo.o....o...o..o...o.....o..oo.o.o...oo..o....o....o.........o.....ooo...o
.o...oo..o........o...oo.o.....o......o...ooo...ooo........o......o.o..oo.........o......o.o.....o..
....oo..oo.oo..o......o.....oo..ooo...oo.o.o....o......o...oo..oo...oo.oo.....o..o....o......o......
..o...oo......o...oo.....o......o......o.o..o..o........oo.oo..o...ooo...o.o...o..oo..ooo.o...o.oo.o
..o....o..oo......o.o...o.oo....o...o.oo........o...o....o............oo.oo.o..o......o.o..o..o..o..
o.oo..o....oo..oo...o.........o.o...o....o.o.....oo........o..o....oooo.o.......o...o...o....oo.....
.......o..o.oooo.o......o.....o.o.oo.o....ooo.ooo.ooo...o..o.o......o.........ooooo.o..o.o........o.
..o......o..............o..oo.....o.o.oo.o...oo...o...o......ooo.oo.o.......o..oo.oo......oo...oo...
.o.o..o.o..o..o..o.....o....o......o....o.oo...o.....o...oooo....o..o.o.o....o....o..ooo..o....o.o..
o....ooo...o......o.....o..oo..o.......oo..o...o.......o.o......o...o...o...o.o.o.o.oo........oo.o.o
oo.....o.......oo.........o....oo...o..o...o...o....o...ooo.oo...oo..o...o...o.........o.o..........
...o....o.o..o..o.o....o....o...ooo.o........oo.o...oo...o..o........oo.o........o..oo....o.......o.
......oo..o.o.o..o.o.....o.o...o.o.o...o.............o.....o...o.o....o.o...oo.o....o...ooo.o..o....
...o.....o.............o.....o.ooo..o...o....oo.oo.....oo..o.o..o........oo.o.o...o.o.ooo.......o.o.
.....o..o.o..o....o..o...o.......oo...o...ooo..o.o.oooooo......o.o....o...o...o.....o..o.........o..
..oo.oo......o..o.o...o.o.......o....o..o.o..o.o..oo.....o..o.......o.....ooo........oo....o....o.o.
..o..oooo..o.o.o.....o......o..oo..ooo.oooo............o.oooo.oo....o....oo.o.....o.o.o.o..o..o.....
....o.oo......oo....o..........o....o.oo...oo......o..........o..o.ooo...oo.......o....o...o........
o.....o.oo............ooo.oo.ooooo.oo..oo.o.......o...oo.......o.o.......oo...o.o..........o....oo..
...o..o............o...o.......o.oo..ooo..o..o..o..o.o..o.....o...o.o...o..oo..o..o..o.....oo.o.....
.....o.....o.ooooo.o........ooo........o....o.o.....o....o..o......o.o..o.o.o..o..ooo..oo.o..o.ooo..
.o...ooo.......o..oo..o.............o.o....o.o.....o..o.o.o...o.oo....oo............oo.o.o..o......o
..o..........o..o...o.o.oo..oo..o......o....o.....o...oo.o..oo...o...oo..o...o..o...o....ooo.o.o.o..
.....o.oo..oo......o.o.o...oo..o.oo...o..oo....o.o..o.o..............o..o......o.....o..oo...o...o..
.....o.oo...o.oo....oo.......o.oo.o.o.o.o.....ooo.....oo.....o.oo....o.o....oo..o..o..o...o.....oo..
...o.o......o.........o..o.......o..ooo.o.....o.....o.oo.....o......ooo.....o.o.o...o...o.o.o.o..oo.
o.oo....o....o..o...o.oo.......o.o.oo......ooo..o..oo..o....oo.o.o.o..oo..........oo.o......o....oo.
o....o...oo.........o.......o..o.o..o.......o..o..o..o...oo....ooo.....o.....o.o...................o
..oo....o.....o...o...oo......oo.ooo......o.o.o.ooooo........o..o.oo..o....oo.o.o...........oo.o....
......ooo.......o........o...oo.o.ooo.oooo.o.....oo....o...o.....oo.oo.o..o...o..o...o...o.......o..
oooo.....o..o.....oo..........o.o.o..o..o.....o..........oo............oo.o.o....oo...o..oo......o.o
.....o...o...o.o...o...o..o......o...o...o.....o.......o.oo....o......oo......oo.....oo.........oo..
..o.....o.o.......o..o..o...........o.......o...ooo..o.o.oooo..o...oo.o.....o.oo..o..oo...oo.o..o.o.
